111111111111111111111111111111
100001110000111000101000000001
110000000001101100001000100111
100010010000111E00000001110011
11011000000011100C000000100111
110000001010111000000000000001
100010000011001000000001100001
100111000010111000001010100001
100000000000000000001000110001
100011000010101000000100100111
11000000C0000P0000000000000011
111000010000000000000100111001
10000111000100000C100010010011
100001110001001000000011001001
111111111111111111111111111111
111111111111111111111111111111
111111111111111111111111111111
100000000000000100000000000001
111111111111111111111111111111